#!/bin/bash

source myenv/bin/activate

/usr/bin/python "/home/mario/Escritorio/MasterMind/Python_MasterMind/Datos y control/Maze.py"


###########################
#                           # 
# ############  #### #    ### 
#         ###        ###    # 
#   ##### ### ##     ###    # 
#       # ### #    #####    # 
#     # # ### #     ######### 
#  ##   # ### # #     # ##### 
#   #   # ### # ####    ##### 
### #   # ### # ####    ##### 
### #   # ##            ##### 
###     #  ## #     # # ##### 
### ### #  ## #         ##### 
#######   ### # # # #         
#############################\
